########################################################################################
#&                                     RRR                                    BB    D  #
# BB             #                      RRR                                   BB       #
#C B             #                        RRR                 BB              BB       #
####            #                           RRRR                                       #
#               #####                         RRRRR                           ##########
#                   F                         RRRR                                     #
#                           BBBB                                    &                  #
#     ###        &          BB                 RRRR                                    #
#                                            RRRRRRR           BBBBB                   #
#                                             RRRRRR                                   #
#           ###                                RRRRRR                                  #
#                                                RRRRRR                                #
#                                                  RRRRRR ########                     #
#         #                    BBBBB              RRRRRR  B   #F #           BB        #
#         #                   BBBBB               RRRRRR  B    & #                     #
#       #####                                    RRRRR    B      #                     #
#       # W #                                     RRRRR   B      #                     #
#       #   &                                     RRRRR   B      #                     #
#       #####             CCCCCCCCCCC                       RRRRR                            &    #
#                        WWWWWWWWWWWWWWWWW                       RRRRR                 BB               #
########################################################################################
