######################
#                    #
#               #    #
#C              #    #
####            #   D#
#               ######
#                   F#
#                    #
#     ###        &   #
#                    #
#                    #
#           ###      #
#                    #
#  &                 #
#         #          #
#         #          #
#         #          #
#         W          #
#                &   #
#                    #
#@                   #
######################
